##.###...##........##........##
#......####........##.#.##...##
#.#.##...##........##.#.##...##
#...##...##........#######...##
#........##........#######...##
######...##........#######...##
##.###.......................##
#......####........#######...##
#.#.##...##........#######...##
#...##...##........##.#.##...##
#........##........##.#.##...##
######...##.#.##...###.#.##...#