##.###...#
#......###
#.#.##...#
#...##...#
#........#
######...#
